8 8 8 8 8 8 8 8 8 8 8 8 8 8 8 8 8 8 8 8
8 5 5 7 7 5 5 8 8 8 8 8 8 8 8 8 8 8 8 8
8 5 5 6 6 5 5 8 8 8 8 8 8 8 8 8 8 8 8 8
8 4 4 4 4 4 4 8 8 8 8 8 8 8 8 8 8 8 8 8
8 4 4 4 4 4 4 8 8 8 8 8 8 8 8 8 8 8 8 8
8 4 4 4 4 4 4 8 8 8 8 8 8 8 8 8 8 8 8 8
8 4 4 4 4 4 4 8 8 8 8 8 8 8 8 8 8 8 8 8
8 4 4 4 4 4 4 8 8 8 8 8 8 8 8 8 8 8 8 8
8 8 4 8 8 8 8 8 8 8 8 8 8 8 8 8 8 8 8 8
8 8 8 8 8 8 8 8 8 8 8 8 8 8 8 8 8 8 8 8
8 8 8 8 8 8 8 8 8 8 8 8 8 8 8 8 8 8 8 8
8 8 8 8 8 8 8 8 8 8 8 8 8 8 8 8 8 8 8 8
8 8 8 8 8 8 8 8 8 8 8 8 8 8 8 8 8 8 8 8
8 8 8 8 8 8 8 8 8 8 8 8 8 8 8 8 8 8 8 8
8 8 8 8 8 8 8 8 8 8 8 8 8 8 8 8 8 8 8 8
8 8 8 8 8 8 8 8 8 8 8 8 8 8 8 8 8 8 8 8
8 8 8 8 8 8 8 8 8 8 8 8 8 8 8 8 8 8 8 8
8 8 8 8 8 8 8 8 8 8 8 8 8 8 8 8 8 8 8 8
8 8 8 8 8 8 8 8 8 8 8 8 8 8 8 8 8 8 8 8
8 8 8 8 8 8 8 8 8 8 8 8 8 8 8 8 8 8 8 8